
















##################################################################################################
#A                                                                                               #
################################################################################################ #
#                                                                                                #
# ################################################################################################
#                                                                                                #
################################################################################################ #
#                                                                                                #
# ################################################################################################
#                                                                                                #
################################################################################################ #
#                                                                                                #
# ################################################################################################
#                                                                                                #
################################################################################################ #
#                                                                                                #
# ################################################################################################
#                                                                                                #
################################################################################################ #
#                                                                                                #
# ################################################################################################
#                                                                                                #
################################################################################################ #
#                                                                                                #
# ################################################################################################
#                                                                                                #
################################################################################################ #
#                                                                                                #
# ################################################################################################
#                                                                                                #
################################################################################################ #
#                                                                                                #
# ################################################################################################
#                                                                                                #
################################################################################################ #
#                                                                                                #
# ################################################################################################
#                                                                                                #
################################################################################################ #
#                                                                                                #
# ################################################################################################
#                                                                                                #
################################################################################################ #
#                                                                                                #
# ################################################################################################
#                                                                                                #
################################################################################################ #
#                                                                                                #
# ################################################################################################
#                                                                                                #
################################################################################################ #
#                                                                                                #
# ################################################################################################
#                                                                                                #
################################################################################################ #
#                                                                                                #
# ################################################################################################
#                                                                                                #
################################################################################################ #
#                                                                                                #
# ################################################################################################
#                                                                                                #
################################################################################################ #
#                                                                                                #
# ################################################################################################
#                                                                                                #
################################################################################################ #
#                                                                                                #
# ################################################################################################
#                                                                                                #
################################################################################################ #
#                                                                                                #
# ################################################################################################
#                                                                                                #
################################################################################################ #
#                                                                                                #
# ################################################################################################
#                                                                                                #
################################################################################################ #
#                                                                                                #
# ################################################################################################
#                                                                                                #
################################################################################################ #
#                                                                                                #
# ################################################################################################
#                                                                                                #
################################################################################################ #
#                                                                                                #
# ################################################################################################
#                                                                                                #
################################################################################################ #
#                                                                                                #
# ################################################################################################
#                                                                                                #
################################################################################################ #
#                                                                                                #
# ################################################################################################
#                                                                                               B#
##################################################################################################