     #######
 ### #B #  #              ####
 # ###  #  #              #  #
 #     ## #################  #
 #         #                 #
##  #####  # #############   #
#   #   # ## #           #   #
#A  #   #    #           #####
#####   ######