#####################
#         #         B
# # # ##### # # #####
# # #   #   # #   # #
# # ##### ######### #
# #               # #
##### ### ### # ### #
#       #   # #     #
### # # ### # # #####
#   # #   # # #   # #
# ##### ##### ##### #
#   # # #   #       #
# # # # # ### #######
# #   #     #       #
# # ######### # # # #
# #     #   # # # # #
# # ### # ####### # #
# #   #         # # #
### # ####### ##### #
#   #       #   #   #
###############A#####