##############
#   # .......#
# A ##.#####.#
# .....#  ##.#
######### #..#
#        B#.##
# ######..#..#
#   #  #.###.#
#   #   .....#
##############
