####################################################################################################
#A                                                                                                 #
################################################################################################## #
#                                                                                                  #
# ##################################################################################################
#                                                                                                  #
################################################################################################## #
#                                                                                                  #
# ##################################################################################################
#                                                                                                  #
################################################################################################## #
#                                                                                                  #
# ##################################################################################################
#                                                                                                  #
################################################################################################## #
#                                                                                                  #
# ##################################################################################################
#                                                                                                  #
################################################################################################## #
#                                                                                                  #
# ##################################################################################################
#                                                                                                  #
################################################################################################## #
#                                                                                                  #
# ##################################################################################################
#                                                                                                  #
################################################################################################## #
#                                                                                                  #
# ##################################################################################################
#                                                                                                  #
################################################################################################## #
#                                                                                                  #
# ##################################################################################################
#                                                                                                  #
################################################################################################## #
#                                                                                                  #
# ##################################################################################################
#                                                                                                  #
################################################################################################## #
#                                                                                                  #
# ##################################################################################################
#                                                                                                  #
################################################################################################## #
#                                                                                                  #
# ##################################################################################################
#                                                                                                  #
################################################################################################## #
#                                                                                                  #
# ##################################################################################################
#                                                                                                  #
################################################################################################## #
#                                                                                                  #
# ##################################################################################################
#                                                                                                  #
################################################################################################## #
#                                                                                                  #
# ##################################################################################################
#                                                                                                  #
################################################################################################## #
#                                                                                                  #
# ##################################################################################################
#                                                                                                  #
################################################################################################## #
#                                                                                                  #
# ##################################################################################################
#                                                                                                  #
################################################################################################## #
#                                                                                                  #
# ##################################################################################################
#                                                                                                  #
################################################################################################## #
#                                                                                                  #
# ##################################################################################################
#                                                                                                  #
################################################################################################## #
#                                                                                                  #
# ##################################################################################################
#                                                                                                  #
################################################################################################## #
#                                                                                                  #
# ##################################################################################################
#                                                                                                  #
################################################################################################## #
#                                                                                                  #
# ##################################################################################################
#                                                                                                  #
################################################################################################## #
#                                                                                                  #
# ##################################################################################################
#                                                                                                  #
################################################################################################## #
#                                                                                                  #
# ##################################################################################################
#                                                                                                  #
################################################################################################## #
#                                                                                                  #
# ##################################################################################################
#                                                                                                  #
#                                                                                                 B#
####################################################################################################