##################################################################################################
#A...............................................................................................#
################################################################################################.#
#................................................................................................#
#.################################################################################################
#................................................................................................#
################################################################################################.#
#................................................................................................#
#.################################################################################################
#................................................................................................#
################################################################################################.#
#................................................................................................#
#.################################################################################################
#................................................................................................#
################################################################################################.#
#................................................................................................#
#.################################################################################################
#................................................................................................#
################################################################################################.#
#................................................................................................#
#.################################################################################################
#................................................................................................#
################################################################################################.#
#................................................................................................#
#.################################################################################################
#................................................................................................#
################################################################################################.#
#................................................................................................#
#.################################################################################################
#................................................................................................#
################################################################################################.#
#................................................................................................#
#.################################################################################################
#................................................................................................#
################################################################################################.#
#................................................................................................#
#.################################################################################################
#................................................................................................#
################################################################################################.#
#................................................................................................#
#.################################################################################################
#................................................................................................#
################################################################################################.#
#................................................................................................#
#.################################################################################################
#................................................................................................#
################################################################################################.#
#................................................................................................#
#.################################################################################################
#................................................................................................#
################################################################################################.#
#................................................................................................#
#.################################################################################################
#................................................................................................#
################################################################################################.#
#................................................................................................#
#.################################################################################################
#................................................................................................#
################################################################################################.#
#................................................................................................#
#.################################################################################################
#................................................................................................#
################################################################################################.#
#................................................................................................#
#.################################################################################################
#................................................................................................#
################################################################################################.#
#................................................................................................#
#.################################################################################################
#................................................................................................#
################################################################################################.#
#................................................................................................#
#.################################################################################################
#................................................................................................#
################################################################################################.#
#................................................................................................#
#.################################################################################################
#................................................................................................#
################################################################################################.#
#................................................................................................#
#.################################################################################################
#................................................................................................#
################################################################################################.#
#................................................................................................#
#.################################################################################################
#................................................................................................#
################################################################################################.#
#................................................................................................#
#.################################################################################################
#................................................................................................#
################################################################################################.#
#................................................................................................#
#.################################################################################################
#................................................................................................#
################################################################################################.#
#................................................................................................#
#.################################################################################################
#...............................................................................................B#
##################################################################################################
