##############
#   #        #
# A ## ##### #
#      #  ## #
######### #  #
#        B# ##
# ######  #  #
#   #  # ### #
#   #        #
##############