     #######
 ### #B #  #              ####
 # ###  #  #              # A#
 #     ## #################  #
 #         #                 #
##  #####  # #############   #
#   #   # ## #           #   #
#   #   #    #           #####
#####   ######