####################################################################################################
#A.................................................................................................#
##################################################################################################.#
#..................................................................................................#
#.##################################################################################################
#..................................................................................................#
##################################################################################################.#
#..................................................................................................#
#.##################################################################################################
#..................................................................................................#
##################################################################################################.#
#..................................................................................................#
#.##################################################################################################
#..................................................................................................#
##################################################################################################.#
#..................................................................................................#
#.##################################################################################################
#..................................................................................................#
##################################################################################################.#
#..................................................................................................#
#.##################################################################################################
#..................................................................................................#
##################################################################################################.#
#..................................................................................................#
#.##################################################################################################
#..................................................................................................#
##################################################################################################.#
#..................................................................................................#
#.##################################################################################################
#..................................................................................................#
##################################################################################################.#
#..................................................................................................#
#.##################################################################################################
#..................................................................................................#
##################################################################################################.#
#..................................................................................................#
#.##################################################################################################
#..................................................................................................#
##################################################################################################.#
#..................................................................................................#
#.##################################################################################################
#..................................................................................................#
##################################################################################################.#
#..................................................................................................#
#.##################################################################################################
#..................................................................................................#
##################################################################################################.#
#..................................................................................................#
#.##################################################################################################
#..................................................................................................#
##################################################################################################.#
#..................................................................................................#
#.##################################################################################################
#..................................................................................................#
##################################################################################################.#
#..................................................................................................#
#.##################################################################################################
#..................................................................................................#
##################################################################################################.#
#..................................................................................................#
#.##################################################################################################
#..................................................................................................#
##################################################################################################.#
#..................................................................................................#
#.##################################################################################################
#..................................................................................................#
##################################################################################################.#
#..................................................................................................#
#.##################################################################################################
#..................................................................................................#
##################################################################################################.#
#..................................................................................................#
#.##################################################################################################
#..................................................................................................#
##################################################################################################.#
#..................................................................................................#
#.##################################################################################################
#..................................................................................................#
##################################################################################################.#
#..................................................................................................#
#.##################################################################################################
#..................................................................................................#
##################################################################################################.#
#..................................................................................................#
#.##################################################################################################
#..................................................................................................#
##################################################################################################.#
#..................................................................................................#
#.##################################################################################################
#..................................................................................................#
##################################################################################################.#
#..................................................................................................#
#.##################################################################################################
#..................................................................................................#
##################################################################################################.#
#..................................................................................................#
#.##################################################################################################
#.                                                                                                 #
#.................................................................................................B#
####################################################################################################
