#####################
#         #.........B
# # # #####.# # #####
# # #   #...# #   # #
# # #####.######### #
# #  .....        # #
#####.### ### # ### #
#  ...  #   # #     #
###.# # ### # # #####
#...# #   # # #   # #
#.##### ##### ##### #
#...# # #   #       #
# #.# # # ### #######
# #.  #     #       #
# #.######### # # # #
# #.....#   # # # # #
# # ###.# ####### # #
# #   #.......  # # #
### # #######.##### #
#   #       #...#   #
###############A#####
