     #######
 ### #B #  #              ####
 # ###. #  #              # A#
 #    .## ################# .#
 #    .... #.................#
##  #####. #.#############   #
#   #   #.##.#           #   #
#   #   #....#           #####
#####   ######
